"filename", "language", "JavaScript", "Vue", "comment", "blank", "total"
"d:\code\github\drift-mood\src\App.vue", "Vue", 0, 24, 11, 5, 40
"d:\code\github\drift-mood\src\components\BottomBar\BottomBar.vue", "Vue", 0, 104, 7, 2, 113
"d:\code\github\drift-mood\src\components\HomeVue.vue", "Vue", 0, 49, 4, 1, 54
"d:\code\github\drift-mood\src\components\LoginVue.vue", "Vue", 0, 121, 3, 6, 130
"d:\code\github\drift-mood\src\components\SaveHint.vue", "Vue", 0, 152, 4, 0, 156
"d:\code\github\drift-mood\src\components\card\CardContent\ChoiseBackground.vue", "Vue", 0, 182, 17, 2, 201
"d:\code\github\drift-mood\src\components\card\CardContent\ChoiseHPhoto.vue", "Vue", 0, 252, 66, 20, 338
"d:\code\github\drift-mood\src\components\card\CardContent\ChoiseMood.vue", "Vue", 0, 150, 18, 4, 172
"d:\code\github\drift-mood\src\components\card\CardContent\SendMood.vue", "Vue", 0, 287, 26, 5, 318
"d:\code\github\drift-mood\src\components\card\CardVue.vue", "Vue", 0, 62, 12, 5, 79
"d:\code\github\drift-mood\src\components\card\TopLine.vue", "Vue", 0, 215, 35, 4, 254
"d:\code\github\drift-mood\src\components\explore\ExploreHome.vue", "Vue", 0, 375, 29, 8, 412
"d:\code\github\drift-mood\src\components\favorites\FavoritesHome.vue", "Vue", 0, 122, 2, 1, 125
"d:\code\github\drift-mood\src\components\myInfo\MyInfoHome.vue", "Vue", 0, 359, 41, 9, 409
"d:\code\github\drift-mood\src\dateClassify.js", "JavaScript", 13, 0, 6, 4, 23
"d:\code\github\drift-mood\src\main.js", "JavaScript", 5, 0, 0, 3, 8
"d:\code\github\drift-mood\src\router.js", "JavaScript", 42, 0, 0, 5, 47
"d:\code\github\drift-mood\src\vuex.js", "JavaScript", 86, 0, 21, 5, 112
"Total", "-", 146, 2454, 302, 89, 2991